data/map/mapImage.png data/map/region_map.png Nazwa*mapy
29 
0  0 0 18 11 2733 2286 2860 2366 7577 11 2 
1  18 0 36 15 2666 2013 2793 2120 8351 6 2 
2  36 0 51 11 2666 2246 2773 2326 9075 4 0 
3  51 0 72 21 2680 2073 2826 2220 8068 5 3 
4  72 0 111 27 2713 2133 2980 2320 7765 0 1 
5  111 0 135 27 2546 2126 2713 2313 3105 13 2 
6  135 0 172 20 2786 2066 3040 2206 1489 11 3 
7  172 0 203 23 2913 2173 3126 2333 7480 10 3 
8  203 0 237 22 2846 2293 3080 2446 1635 10 4 
9  237 0 278 31 2293 2053 2573 2266 4670 13 2 
10  278 0 333 37 2393 2253 2766 2506 5711 0 0 
11  333 0 367 29 2466 1940 2700 2140 2160 14 0 
12  367 0 397 41 3020 2213 3226 2493 1175 2 3 
13  397 0 452 51 2960 1980 3333 2326 4180 4 1 
14  452 0 496 30 2746 1880 3046 2086 3594 2 4 
15  496 0 538 40 2160 2240 2446 2513 7625 12 0 
16  538 0 610 50 2813 1640 3300 1980 6449 10 4 
17  610 0 667 53 3173 2233 3560 2593 1565 13 0 
18  667 0 735 54 3080 1760 3540 2126 9445 10 5 
19  735 0 791 36 3306 2040 3686 2286 8088 2 4 
20  791 0 864 45 3460 1813 3953 2120 5868 0 3 
21  864 0 933 48 3586 2053 4053 2380 4696 9 4 
22  933 0 1002 36 3453 2240 3920 2486 7483 14 4 
23  1002 0 1063 33 3480 2386 3893 2613 5681 7 1 
24  1063 0 1099 45 3840 2340 4086 2646 2041 9 3 
25  1099 0 1130 25 3926 2620 4140 2793 6229 5 1 
26  1130 0 1156 42 4026 2526 4206 2813 2770 12 2 
27  1156 0 1187 43 4126 2533 4340 2826 1575 3 4 
28  1187 0 1237 51 3760 2706 4100 3053 3115 1 5 
29 
0 0 0 Helms*Deep 54 0 1 0 750 750 750 0 0 0 
1 1 0  95 0 1 0 750 750 750 0 0 0 
2 2 1  12 0 1 0 750 750 750 0 0 0 
3 3 1  54 0 1 0 750 750 750 0 0 0 
4 4 0  14 0 1 0 750 750 750 0 0 0 
5 5 1  11 0 1 0 750 750 750 0 0 0 
6 6 1  48 0 1 0 750 750 750 0 0 0 
7 7 1  56 0 1 0 750 750 750 0 0 0 
8 8 0  72 0 1 0 750 750 750 0 0 0 
9 9 1  104 0 1 0 750 750 750 0 0 0 
10 10 1  84 0 1 0 750 750 750 0 0 0 
11 11 1  74 0 1 0 750 750 750 0 0 0 
12 12 0  57 0 1 0 750 750 750 0 0 0 
13 13 1  83 0 1 0 750 750 750 0 0 0 
14 14 1  69 0 1 0 750 750 750 0 0 0 
15 15 1  25 0 1 0 750 750 750 0 0 0 
16 16 0  82 0 1 0 750 750 750 0 0 0 
17 17 0  12 0 1 0 750 750 750 0 0 0 
18 18 1  89 0 1 0 750 750 750 0 0 0 
19 19 0  73 0 1 0 750 750 750 0 0 0 
20 20 1  37 0 1 0 750 750 750 0 0 0 
21 21 1  52 0 1 0 750 750 750 0 0 0 
22 22 0  73 0 1 0 750 750 750 0 0 0 
23 23 0  23 0 1 0 750 750 750 0 0 0 
24 24 1  94 0 1 0 750 750 750 0 0 0 
25 25 0  42 0 1 0 750 750 750 0 0 0 
26 26 0  63 0 1 0 750 750 750 0 0 0 
27 27 0  20 0 1 0 750 750 750 0 0 0 
28 28 0  98 0 1 0 750 750 750 0 0 0 
52 
3 1 0 
4 0 0 
4 2 0 
4 3 0 
5 2 0 
5 3 0 
6 3 0 
6 4 0 
7 4 0 
7 6 0 
8 0 0 
8 7 0 
9 5 0 
10 0 0 
10 5 0 
10 9 0 
11 1 0 
11 5 0 
11 9 0 
12 7 0 
13 6 0 
13 7 0 
13 12 0 
14 1 0 
14 6 0 
14 13 0 
15 9 0 
15 10 0 
16 14 0 
17 12 0 
17 13 0 
18 13 0 
18 16 0 
19 13 0 
19 17 0 
19 18 0 
20 18 0 
20 19 0 
21 19 0 
21 20 0 
22 17 0 
22 19 0 
22 21 0 
23 22 0 
24 21 0 
24 22 0 
24 23 0 
25 24 0 
26 24 0 
26 25 0 
27 26 0 
28 25 0 
29 
2808 2353 2 0 
2762 2034 1 0 
2685 2248 2 0 
2723 2116 3 0 
2813 2235 3 0 
2664 2184 1 0 
2930 2121 3 0 
3025 2263 2 0 
2980 2388 0 0 
2427 2185 3 0 
2566 2369 4 0 
2573 2037 1 0 
3090 2373 2 0 
3145 2151 2 0 
2932 1982 0 0 
2282 2353 3 0 
3020 1805 4 0 
3394 2388 4 0 
3313 1970 4 0 
3469 2191 2 0 
3715 1989 1 0 
3826 2202 3 0 
3683 2380 0 0 
3724 2521 0 0 
3965 2530 1 0 
4047 2716 0 0 
4142 2647 4 0 
4233 2697 0 0 
3894 2888 1 0 
